{
	"tileset" : "chemin.png",
		"terrain" : [
		[12,14,14,14,14,14,14,14,14, 14, 14, 14, 14,14,  16],
		[11, 2, 2, 2, 2, 2, 2, 2, 2,  2,  2,  2,  2, 2,   9],
		[11, 2, 10, 2,10, 2,10, 2,10,  2,  10,  2,  10, 2,   9],
		[11, 2, 2, 2, 2, 2, 2, 2, 2,  2,  2,  2,  2, 2,   9],
		[11, 2, 10, 2,10, 2,10, 2,10,  2,  10,  2,  10, 2,   9],
		[11, 2, 2, 2, 2, 2, 2, 2, 2,  2,  2,  2,  2, 2,   9],
		[11, 2, 10, 2,10, 2,10, 2,10,  2,  10,  2,  10, 2,   9],
		[11, 2, 2, 2, 2, 2, 2, 2, 2,  2,  2,  2,  2, 2,   9],
		[11, 2, 10, 2,10, 2,10, 2,10,  2,  10,  2,  10, 2,   9],
		[11, 2, 2, 2, 2, 2, 2, 2, 2,  2,  2,  2,  2, 2,   9],
		[11, 2, 10, 2,10, 2,10, 2,10,  2,  10,  2,  10, 2,   9],
		[11, 2, 2, 2, 2, 2, 2, 2, 2,  2,  2,  2,  2, 2,   9],
		[8,6, 6, 6, 6, 6, 6, 6, 6,  6,  6,  6,  6, 6, 4]
			],
	"terrainKO" : [
		[12,14,14,14,14,14,14,14,14, 14, 14, 14, 14,14, 14, 14, 14, 14,14, 14,14,14,14,14,14,14,14, 16],
		[11, 2,2, 2,2, 2,2, 2,2, 2,2, 2,2, 2,2, 2,2,  2,2,  2,2,  2,2,  2,2, 2,2,  9],
		[11, 2,2, 2,2, 2,2, 2,2, 2,2, 2,2, 2,2, 2,2,  2,2,  2,2,  2,2,  2,2, 2,2,  9],
		[11, 2,2, 5, 7, 2,2, 5, 7, 2,2, 5, 7,  2,2,  5, 7, 2,2,  5, 7,  2,2,  5,7,2,2, 9],
		[11, 2,2, 13, 15, 2,2, 13, 15, 2,2,13, 15,  2,2, 13, 15, 2,2,13, 15,  2,2,13, 15,  2,2, 9],
		[11, 2,2, 2,2, 2,2, 2,2, 2,2, 2,2, 2,2, 2,2,  2,2,  2,2,  2,2,  2,2, 2,2,     9],
		[11, 2,2, 2,2, 2,2, 2,2, 2,2, 2,2, 2,2, 2,2,  2,2,  2,2,  2,2,  2,2, 2,2,  9],
		[11, 2,2, 5, 7, 2,2, 5, 7, 2,2, 5, 7,  2,2,  5, 7, 2,2,  5, 7,  2,2,  5,7,2,2, 9],
		[11, 2,2, 13, 15, 2,2, 13, 15, 2,2,13, 15,  2,2, 13, 15, 2,2,13, 15,  2,2,13, 15,  2,2, 9],
		[11, 2,2, 2,2, 2,2, 2,2, 2,2, 2,2, 2,2, 2,2,  2,2,  2,2,  2,2,  2,2, 2,2,    9],
		[11, 2,2, 2,2, 2,2, 2,2, 2,2, 2,2, 2,2, 2,2,  2,2,  2,2,  2,2,  2,2, 2,2,  9],
		[11, 2,2, 5, 7, 2,2, 5, 7, 2,2, 5, 7,  2,2,  5, 7, 2,2,  5, 7,  2,2,  5,7,2,2, 9],
		[11, 2,2, 13, 15, 2,2, 13, 15, 2,2,13, 15,  2,2, 13, 15, 2,2,13, 15,  2,2,13, 15,  2,2, 9],
		[11, 2,2, 2,2, 2,2, 2,2, 2,2, 2,2, 2,2, 2,2,  2,2,  2,2,  2,2,  2,2, 2,2,  9],
		[11, 2,2, 2,2, 2,2, 2,2, 2,2, 2,2, 2,2, 2,2,  2,2,  2,2,  2,2,  2,2, 2,2,  9],
		[11, 2,2, 5, 7, 2,2, 5, 7, 2,2, 5, 7,  2,2,  5, 7, 2,2,  5, 7,  2,2,  5,7,2,2, 9],
		[11, 2,2, 13, 15, 2,2, 13, 15, 2,2,13, 15,  2,2, 13, 15, 2,2,13, 15,  2,2,13, 15,  2,2, 9],
		[11, 2,2, 2,2, 2,2, 2,2, 2,2, 2,2, 2,2, 2,2,  2,2,  2,2,  2,2,  2,2, 2,2,    9],
		[11, 2,2, 2,2, 2,2, 2,2, 2,2, 2,2, 2,2, 2,2,  2,2,  2,2,  2,2,  2,2, 2,2,  9],
		[11, 2,2, 5, 7, 2,2, 5, 7, 2,2, 5, 7,  2,2,  5, 7, 2,2,  5, 7,  2,2,  5,7,2,2, 9],
		[11, 2,2, 13, 15, 2,2, 13, 15, 2,2,13, 15,  2,2, 13, 15, 2,2,13, 15,  2,2,13, 15,  2,2, 9],
		[11, 2,2, 2,2, 2,2, 2,2, 2,2, 2,2, 2,2, 2,2,  2,2,  2,2,  2,2,  2,2, 2,2,   9],
		[11, 2,2, 2,2, 2,2, 2,2, 2,2, 2,2, 2,2, 2,2,  2,2,  2,2,  2,2,  2,2, 2,2,  9],
		[8,6, 6, 6, 6, 6, 6, 6, 6,  6,  6,  6,  6, 6,  6,  6,  6,  6, 6,  6, 6, 6, 6, 6, 6, 6, 6,  4]
	],
	"terrain2" : [
		[2, 2, 2, 2, 2, 2, 9, 10, 11,  2,  2,  2,  2,2,  2,  2,  2,  2,  2],
		[2, 2, 2, 2, 2, 2, 9, 10, 11,  2,  2,  2,  2,2,  2,  2,  2,  2,  2],
		[2, 2, 2, 2, 2, 2, 9, 10, 11,  2,  2,  2,  2,2,  2,  2,  2,  2,  2],
		[2, 2, 2, 2, 2, 2, 9, 10, 11,  2,  2,  2,  2,2,  2,  2,  2,  2,  2],
		[2, 2, 2, 2, 2, 2, 9, 10, 11,  2,  2,  2,  2,2,  2,  2,  2,  2,  2],
		[2, 2, 2, 2, 2, 2, 9, 10, 11,  2,  2,  2,  2,2,  2,  2,  2,  2,  2],
		[2, 2, 2, 5, 6, 6, 4, 10,  8,  6,  6,6,  6,  6,  6,  6,  6,  6,  6],
		[2, 2, 2, 9, 10, 10, 10, 10, 10, 10, 10, 10,10, 10, 10, 10, 10, 10, 10],
		[2, 2, 2, 13, 14, 14, 16, 10, 12, 14, 14, 14, 14,14, 14, 14, 14, 14, 14],
		[2, 2, 2, 2, 2, 2, 9, 10, 11,  2,  2,  2,  2,2,  2,  2,  2,  2,  2],
		[2, 2, 2, 2, 2, 2, 9, 10, 11,  2,  2,  2,  2,2,  2,  2,  2,  2,  2],
		[2, 2, 2, 2, 2, 2, 9, 10, 11,  2,  2,  2,  2,2,  2,  2,  2,  2,  2],
		[2, 2, 2, 2, 2, 2, 9, 10, 11,  2,  2,  2,  2,2,  2,  2,  2,  2,  2],
		[2, 2, 2, 2, 2, 2, 9, 10, 11,  2,  2,  2,  2,2,  2,  2,  2,  2,  2],
		[2, 2, 2, 2, 2, 2, 9, 10, 11,  2,  2,  2,  2,2,  2,  2,  2,  2,  2]
	]


}